##########
#   *    #
#        #
#        #
#        #
#        #
#        #
#        #
#        #
#        #
#   #### #
#     G# #
##########