##########
#        #
# ### ## #
# # # #  #
# # # ####
# # ##   #
#   ## # #
# #  # # #
#*##   #G#
##########