##########
#   *    #
# ###### #
#  #     #
##   ## ##
#  # ##  #
# ##  ## #
#  ## ## #
##  #  # #
# #    ###
# ###### #
#     G# #
##########