######################
#                    #
# ################## #
# #                # #
# # ############## # #
# # #       #      # #
# # # ##### # ###### #
# # #       #      # #
# #G#*## ## ###### # #
# # #### ## #      # #
#        ## # ###### #
######## ## #        #
#             ########
######################