##############
#*  ##########
###    #     #
###### ##### #
######       #
##     ### ###
###### ### #G#
# #### ##### #
#            #
##############
