##*##
#  ##
# # #
# # #
#   #
### #
#G  #
#####