##############
#     *      #
# ########## #
#            #
###### #######
# ##      ## #
# ## #### ## #
# ## #### ## #
#G   ####    #
##############
