##########
#        #
# # # #  #
# # ### ##
# ###*#  #
# #   ## #
# # #### #
G #      #
##########